6 7
#######
#..####
#....##
#....##
#.....#
#######
5 6
3
4 4
3 4
5 5
4 5
5 6
5 5
