11 15
###############
############..#
#######.......#
#........####.#
#....###.#..#.#
##.###...#..#.#
#....###.#..#.#
#........####.#
#######.......#
############..#
###############
6 7
5
5 9
7 4
5 3
8 5
7 9
8 14
7 14
4 14
5 14
6 14
