9 8
########
#...####
#....###
##....##
##.....#
##.....#
##....##
##..####
########
3 4
6
3 3
4 5
5 6
4 4
6 3
6 5
6 4
5 4
5 5
7 4
4 3
5 3
