7 7
#######
#.....#
#.....#
#.....#
##....#
####..#
#######
2 2
5
3 3
4 4
3 4
2 4
3 5
2 6
4 6
6 6
5 6
3 6
