8 12
############
###.#......#
#..........#
#...####.#.#
###........#
###..#....##
###..###..##
######.#####
6 10
5
5 9
6 9
5 8
3 4
6 5
2 9
2 8
2 11
2 10
2 4
