7 7
#######
##..###
#...###
#....##
#.....#
##...##
#######
5 2
4
4 4
3 3
4 3
5 3
4 5
5 6
2 4
6 5
