5 11
###########
#.........#
#.#######.#
#.........#
###########
4 6
2
2 8
4 4
2 5
4 4
