12 18
##################
##.............###
###.##.#.#####..##
##.....#.....##.##
##..#.######.##..#
##.....#.....###.#
##.#######.#.#.#.#
#..........#.#.#.#
#####.###.##.....#
#####..##..###.#.#
##...............#
##################
6 9
11
6 4
7 3
2 6
11 6
6 11
9 10
10 15
3 9
4 12
9 6
8 15
4 10
6 9
4 9
6 7
7 15
8 2
11 6
11 3
2 3
8 15
5 3
