8 6
######
#...##
#...##
#...##
#....#
#....#
#...##
######
6 5
3
6 4
5 4
3 4
6 3
3 3
4 3
