7 8
########
#####..#
#......#
#......#
#..#####
#..#####
########
5 2
3
3 3
5 3
3 5
6 2
5 2
3 3
