6 9
#########
#.......#
#.......#
##.#.#.##
##.....##
#########
3 3
4
3 4
4 7
2 3
3 5
5 4
5 7
2 3
5 3
