11 14
##############
###..#..#..###
#............#
#.#..##.#..#.#
#............#
###.#....#.###
#............#
#.#..#.##..#.#
#............#
###..#..#..###
##############
2 7
10
7 8
5 10
5 7
3 11
7 5
9 11
9 4
3 7
3 4
9 7
4 10
6 9
6 6
4 5
8 11
4 4
8 10
8 5
4 11
8 4
