7 7
#######
##..###
#...###
##...##
#.....#
#.....#
#######
2 4
3
3 4
6 5
5 3
6 3
3 2
3 4
