14 19
###################
##...#.......#...##
##...#..#.#..#...##
##......#.#......##
##.##.#.#.#.#.##.##
#.....#.#.#.#.....#
#..#...........#..#
##.##..#...#..##.##
#.................#
#..##..#...#..##..#
##.##.##...##.##.##
#.................#
#.................#
###################
8 10
17
6 4
4 7
9 14
3 13
6 6
7 9
8 11
4 13
8 9
9 10
12 9
7 10
7 11
12 11
3 7
9 6
6 14
2 7
4 10
6 4
13 2
11 6
5 6
5 12
8 10
2 10
5 14
2 13
9 16
13 18
9 4
11 14
6 16
5 8
