9 11
###########
##....#####
##......###
##......###
##.########
#.........#
#.........#
#######...#
###########
3 8
7
6 4
4 7
7 5
4 3
3 7
3 4
3 5
6 9
6 8
6 10
8 10
8 9
8 8
7 10
