8 6
######
##..##
##...#
#....#
#....#
##..##
##..##
######
2 3
3
4 4
3 4
3 3
7 4
5 4
3 4
