10 10
##########
#..#######
#.......##
#....#..##
#...##.###
###.#....#
###......#
####.....#
####.....#
##########
8 7
5
7 6
7 7
8 8
8 6
7 8
3 8
3 6
3 7
3 4
3 5
