9 12
############
#####...####
##....#....#
##.........#
##.###.#####
#......#####
#......#####
####..######
############
4 11
4
4 10
4 4
4 6
4 8
7 6
6 7
7 7
6 6
