7 7
#######
###..##
#.....#
#.....#
##....#
##.#..#
#######
6 3
3
4 5
5 4
5 5
4 4
3 4
3 3
