14 26
####################...###
#..................#####.#
##......#.#.###..........#
########...#...##....#...#
##.........#...#.....#.###
##.#..#.......#..###...###
##....#####......#.....###
##....##.........#.....###
###...#....####.....##.###
###................###...#
#...#.......#......#.#...#
#........#...............#
#...#...#................#
##########################
2 2
18
5 4
5 10
7 15
7 22
10 11
10 17
7 6
7 13
10 6
8 10
10 19
11 9
8 19
10 14
8 17
6 17
4 20
8 4
12 2
13 12
3 25
13 2
13 13
13 14
13 25
12 7
13 15
2 11
12 25
12 18
2 13
2 12
2 25
2 15
2 14
12 22
