8 8
########
##.....#
##...#.#
##..#..#
#......#
#......#
##...###
########
4 3
6
6 4
3 3
6 6
4 4
3 4
5 3
2 7
4 7
2 6
3 7
2 5
2 4
