14 26
##########################
#.......................##
#..#........#..#..#....#.#
#.#.#......#..#..#....#..#
#....##...#..#..#....#...#
#....#...#..#..#....#....#
#.#.......#..#..#..#.....#
#..#..........#..#..#....#
#.#............#...#.#...#
#..#............#.....#..#
#...#............#.......#
#..#.....................#
#........................#
##########################
6 7
32
9 8
10 6
7 7
11 23
11 14
9 18
5 8
10 8
12 20
10 7
7 6
8 10
10 12
11 22
7 19
12 14
10 13
8 11
11 9
12 18
11 21
9 6
11 12
6 8
8 12
11 8
9 9
10 14
11 20
12 23
7 8
9 12
3 25
7 21
8 23
7 25
6 24
11 24
5 23
9 25
8 24
13 25
7 24
12 24
5 25
6 25
9 17
6 22
4 24
9 24
7 23
11 25
8 25
13 24
12 25
5 24
10 24
4 25
6 23
7 22
8 22
10 25
9 23
9 19
