7 9
#########
####..###
####..###
#.......#
#.......#
#.......#
#########
4 5
6
4 6
5 5
5 6
4 4
5 7
5 3
2 6
4 4
6 2
3 6
2 5
3 5
