10 11
###########
#####.....#
#####.....#
#####.....#
#####.....#
#.........#
#.........#
#.........#
#.........#
###########
7 8
12
6 4
6 9
6 7
6 8
6 6
7 7
8 9
8 8
8 7
8 4
8 6
7 9
2 7
4 7
8 3
4 9
8 2
2 9
4 8
2 8
6 3
3 9
6 2
3 7
