8 9
#########
#.....###
#.....###
#.....###
#.......#
#####.#.#
#####...#
#########
2 2
6
5 5
4 5
4 4
4 3
2 5
3 5
3 2
2 3
2 2
4 2
5 2
2 4
