10 14
##############
#####....#####
#####....#####
#####....#####
#............#
#............#
#####....#####
#####....#####
#####....#####
##############
6 8
16
6 4
4 7
5 4
4 9
4 6
6 7
4 8
5 11
6 11
7 6
7 7
3 8
8 7
7 8
5 8
7 9
2 7
9 7
2 6
2 9
2 8
5 12
9 8
5 13
9 9
6 3
6 2
6 13
9 6
6 12
5 2
5 3
