14 14
##############
###......#####
##..#.##....##
##.##..##.#..#
##.#.......#.#
#....#.##....#
#.##.#.....#.#
#.#.....#.##.#
#....##.#....#
#.#.......#.##
#..#.##..##.##
##....##.#..##
#####......###
##############
13 6
8
4 10
6 4
11 5
9 3
9 11
3 6
6 12
12 9
6 7
9 8
7 7
8 8
8 7
8 6
7 8
7 9
