14 26
##########.####.##########
######.#.###..###.#.######
####..................####
####...#.###..###.#...####
###...##..........##...###
##.......#.#..#.#.......##
#.....##...#..#...##.....#
#....###.###..###.###....#
#...##...#.#..#.#...##...#
#..###.#.###..###.#.###..#
#..#.......#..#.......#..#
####.#.#.#.#..#.#.#.#.####
#..........#..#..........#
##########################
13 16
18
7 14
8 3
8 13
8 24
9 14
3 13
5 6
4 14
3 21
7 4
10 24
5 21
3 6
6 22
11 14
10 3
7 23
6 5
2 7
13 23
13 2
2 9
2 18
13 3
13 14
13 4
13 24
13 25
2 20
5 13
4 13
5 14
2 13
2 14
3 14
6 14
