14 26
###############...########
#..#...##.##..#####......#
##...#........#......##.##
##.#.####.##.....##......#
##........#####..######.##
####.####......##.....#.##
#.....#####.#.........#.##
#...........#.#####...#.##
#.............#.###.###.##
#...............##.......#
#...............#........#
#...............#........#
#...............#........#
##########################
2 2
29
7 21
9 8
10 6
8 5
3 24
12 20
10 12
12 6
12 24
9 11
8 6
12 10
9 7
12 8
12 21
8 2
4 5
10 13
9 10
10 24
12 18
13 6
11 12
8 3
9 9
12 19
10 14
11 6
8 4
11 2
13 4
12 5
9 4
10 3
12 2
12 20
11 5
13 3
12 24
12 3
12 21
11 4
10 4
13 2
6 11
9 3
10 24
12 18
2 24
12 22
10 5
9 2
11 3
12 19
13 5
12 4
9 5
10 2
