12 18
########..########
#......#..#......#
#.####.####.####.#
#.#..#......#..#.#
#.#..##....##..#.#
#.#..#......#..#.#
#.#..###..######.#
#.####........##.#
#.##..........##.#
#.##..........##.#
#....########....#
######......######
6 8
10
9 13
6 9
8 11
6 10
9 8
10 6
10 13
8 8
9 11
9 6
10 8
4 7
10 11
10 10
8 10
8 9
4 12
7 10
10 9
7 9
