14 26
##########################
#...#................#...#
#....###.###..###.###....#
#........................#
###.###..#.#..#.#..###.###
#.....####.#..#.####.....#
#...#................#...#
#.#....................#.#
#.....####.#..#.####.....#
#.####..............####.#
#......###.#..#.###......#
#.###......#..#......###.#
#.....#####....#####.....#
#######...######...#######
8 13
20
7 12
7 7
8 19
3 24
7 20
3 3
7 15
8 10
12 17
4 24
12 10
8 25
8 2
3 23
4 16
8 17
4 11
8 8
4 3
3 4
3 25
6 2
6 24
12 2
10 7
9 21
8 20
6 3
6 25
2 2
3 2
2 6
12 25
4 25
8 7
4 2
9 6
2 21
10 20
2 25
