14 26
###..#####################
#.#.##..##.......#########
#.###.....#.#.##....######
#.....#.#.#...##.##.######
####......#.#.##.##......#
####.#......#.##....####.#
####.#.#.#....##.##....#.#
###....#.#.##.......##...#
##..##.#.#.###.#.##.##.#.#
##.......#..........##.#.#
#..#######.##.######...#.#
#..........##.#......###.#
#..######..#....####.....#
####....#########..#######
8 11
2
7 14
5 5
2 15
2 11
