14 26
##########################
#.........#....#.........#
#.#####....#..#....#####.#
#.#.##..............##.#.#
#.###...#........#...###.#
#.##...#.#......#.#...##.#
#.....#...#....#...#.....#
#.....#...#....#...#.....#
#.##...#.#......#.#...##.#
#.###...#........#...###.#
#.#.##..............##.#.#
#.#####....#..#....#####.#
#.........#....#.........#
##########################
8 2
24
10 11
5 13
6 2
12 9
9 25
11 10
9 15
6 25
6 15
4 10
5 11
10 13
12 18
3 9
6 12
11 17
5 16
9 2
10 16
4 17
5 14
3 18
10 14
9 12
11 16
11 11
2 18
10 15
2 12
3 17
13 12
2 9
13 25
3 10
5 12
10 12
12 17
2 2
12 10
13 2
13 15
4 16
5 15
4 11
13 18
2 25
2 15
13 9
