10 10
##########
#....#####
###..#####
#....#####
#....#####
###......#
###......#
###..#####
###..#####
##########
2 2
4
8 5
7 8
5 5
6 6
4 2
5 2
4 3
5 3
