14 24
##########....##########
#######..#...##......###
######...##..#..####...#
######....#..#...#.##..#
#........#####.#.#####.#
#.###.##...........#.#.#
#..##.###.####.#.#.#.#.#
##..#.##..####.....#.#.#
####.........#.#.#.#.#.#
####..###........#.###.#
####..#########....#...#
#####..####...#####....#
######....#.....#......#
###########.....########
10 12
4
3 8
5 17
10 17
12 21
8 17
3 9
13 18
11 19
