13 25
###########.#############
####...#..#.#.....#.#####
##.#####..###.....###..##
##.............#.......##
##..####..###.....####.##
#####..#..#.#.....#..#.##
###########.#######..#.##
######################.##
######################.##
#...................##..#
##################......#
##################..#####
#########################
4 9
4
3 15
3 17
5 17
5 15
6 9
3 3
2 9
10 2
