9 18
#########..#######
###.....####...###
##..##...##.....##
##.####......##.##
#..####......###.#
#...##........##.#
#....########....#
##.###......###.##
####..........####
5 9
4
6 10
4 8
4 3
3 13
3 16
7 5
6 7
6 14
