10 12
############
####....####
###......###
##........##
#..........#
#..........#
##........##
###......###
####....####
############
6 5
9
4 7
6 9
6 8
9 8
3 8
3 6
8 6
8 5
5 3
4 7
2 6
6 9
9 8
6 2
3 6
7 10
8 6
5 3
