8 8
########
###...##
#...#.##
#.#....#
#....#.#
##.#...#
##...###
########
2 6
3
4 5
3 3
6 3
5 4
4 4
5 5
