11 14
##############
########..####
########..####
#............#
####.###.#####
####...#..####
####.#.##..###
####........##
#########..###
#########.####
##############
8 11
2
5 9
5 5
4 13
4 2
