14 25
#########################
#...#####################
#.#.#......#............#
#.#.#.######.##.#######.#
#.#.#.........#.#.....#.#
#.#############.#.###.#.#
#...............#.#...#.#
###############.#.#####.#
#...#...........#.......#
#.#.#########.###########
#.#.........#...........#
#.#####################.#
#.......................#
#########################
5 14
5
7 21
11 11
3 10
4 4
9 7
7 20
5 4
3 11
9 6
11 12
