14 26
##########################
#...............##..#....#
#....##.#.#...####..##...#
#....##.#..........###...#
#....###.....##.##..#....#
#.##..####.#.######......#
#.#.#.#...#......#..###..#
#.#.###..#...#.###....#.##
#....##...#.#....###..#.##
#.....#.##....#...##...###
#..#...##.....#.#......#.#
#.#.#..###.####.#...#....#
#...#.##.#....#.#####...##
#######..########...######
2 19
14
4 10
10 4
13 13
8 12
7 13
4 17
5 24
11 23
7 16
2 24
11 18
11 25
3 4
3 14
8 13
3 3
13 14
4 15
3 10
4 17
5 25
12 18
2 25
7 17
12 23
11 25
10 3
9 12
