14 26
#######............#######
#.....#............#.....#
#.....#...######...#.....#
###..##..##..#.###.##..###
####.##..#.......#.##.####
###...####...#...###...###
###.........###........###
###...####...#...###...###
####..#..##.....##.##.####
####..#...##...##..##.####
####..#....#####...#..####
#.....#............#.....#
#.....#............#.....#
#######............#######
8 13
11
3 24
12 22
3 3
3 22
8 12
12 24
7 5
6 12
7 22
6 16
3 5
12 2
13 2
13 3
4 15
13 4
12 6
13 5
12 5
13 6
12 4
12 3
