14 26
###.......########.###.###
#.###.#####..##..###.###.#
#.#.###...#........#.....#
#.#.##............#..##..#
#.#.##.##............#####
#.#.###...#...#.##.#.#####
#.....#...#......#.#######
###.#####.##.##..#.#..####
#....#.#..##.##.#..#.##.##
#.##..##..#........###...#
##.#...##.##.###...##.##.#
#..#..#...####.##..#####.#
#........##....#..###....#
##########.....####.######
2 2
17
3 24
3 25
13 23
10 17
13 24
13 25
12 25
4 14
5 13
10 25
11 22
10 24
4 12
4 25
2 25
10 23
11 25
3 24
3 25
3 12
13 23
13 24
3 13
13 25
12 25
10 12
10 25
11 22
10 24
4 25
2 25
10 23
11 25
3 14
