13 23
#######################
#######..........######
#######........#.######
###.#.....####.......##
##....#...#..#.###....#
#...#.....#..#........#
#.........#..#.###....#
#...#.#...#..#........#
#.#.#.#...#.##...#....#
#.#.#.#.#.###..#.#.#.##
#.#.#.#.#..##..#.#.#.##
#..........##........##
#######################
11 11
18
7 3
11 10
7 21
11 4
6 8
11 17
11 8
2 11
7 7
6 21
8 21
6 3
8 8
5 21
11 21
11 15
11 19
11 6
6 19
2 16
6 4
6 9
4 9
4 6
2 9
4 19
6 6
4 16
8 9
2 13
8 19
2 12
8 6
8 16
6 16
8 4
