11 16
######.#########
###..#.#.....###
#....#.#.....###
#....###.#..####
#......#..######
#.##.#....######
#........##...##
#.....##.#....##
#.....##......##
##....##.##....#
################
6 8
14
8 14
8 3
9 13
3 12
8 12
9 3
3 11
9 9
6 2
4 3
9 4
9 5
9 6
5 3
7 14
10 5
10 9
8 2
10 4
7 12
9 2
10 13
10 6
4 12
2 5
10 3
2 4
4 11
