9 9
#########
###..####
###..####
#.......#
#.......#
###..####
###..####
###..####
#########
4 2
4
6 5
5 7
5 3
3 5
4 5
5 4
4 4
5 5
