14 26
############.........#####
#.......##.#.....#####...#
#######.##.#..####.......#
#######.##.#..#..........#
#######....#.##..##...####
#######....###...##.######
##########.......##.######
##########...#..###.######
##########...#####....####
###..........#..#.......##
###....###..##..#######.##
#####..#.####.........####
#####..###################
##########################
3 19
6
9 21
12 7
10 6
3 20
4 25
2 25
3 24
3 25
4 25
2 25
4 24
2 24
