10 16
################
########..######
########...#####
##.............#
##.....##...#.##
##..##..#.#....#
#....##.##..#.##
##..##.........#
####.........###
################
8 12
5
5 4
3 10
8 10
4 12
5 3
4 7
6 10
7 5
7 2
8 15
