14 13
#############
#...........#
#.#######...#
#..###..#...#
##...#..#...#
####.#..#...#
####.#..#...#
####.##.#...#
####..#.#...#
####..###...#
####..##....#
#####.##....#
#####.......#
#############
2 2
12
10 11
11 11
5 11
6 11
8 11
2 11
3 11
9 11
12 11
7 11
4 11
13 11
13 12
3 12
8 12
7 12
5 12
12 12
10 12
4 12
2 12
6 12
11 12
9 12
