12 12
############
#..........#
#.#......#.#
#..#....#..#
#...#..#...#
#..........#
#..........#
#...#..#...#
#..#....#..#
#.#......#.#
#..........#
############
6 6
8
6 8
5 6
5 7
7 5
8 7
8 6
7 8
6 5
3 2
11 10
10 11
3 11
11 3
2 10
2 3
10 2
