11 15
###############
#...#.#.#######
#.#.#.#.#######
#.............#
#.###.#.###.#.#
#.........#...#
#.#.#.###.#.#.#
#...#.........#
#####.#.#.#.#.#
#.......#.#.#.#
###############
10 4
9
7 14
10 5
4 6
5 8
7 12
4 8
8 11
8 10
6 5
2 6
8 2
6 8
10 10
2 8
10 12
10 14
4 2
10 2
