11 10
##########
##.#######
#........#
##.#####.#
##.....#.#
##.###.#.#
##...#.#.#
##.#.#.#.#
##.......#
######.###
##########
9 3
4
7 4
3 3
9 4
9 7
10 7
3 2
2 3
9 6
