11 19
###################
#########.........#
#########.........#
#..........###..###
#.....#....#.#...##
#####.#....#.#...##
#####..#.#...#..###
######.#.....#..###
##########..##..###
##############..###
###################
8 7
4
7 11
7 9
9 16
3 13
4 3
3 12
5 13
3 14
