14 25
###########......########
###.#.....########.....##
#.###.###..........##...#
#.##...##.########......#
#......#...#...###.##...#
#.##...#.#.#.#.....###.##
#.###.##...#...#####.#.##
#.##...##.###.########.##
#.....##......##...##...#
#.##...##.######......#.#
#.###.##...#.......#....#
#......#.#...#.##.###.###
######.....#...........##
#########################
3 2
20
6 6
11 2
10 6
11 23
10 21
11 14
12 9
5 5
10 18
7 10
8 6
7 14
10 19
6 23
9 13
12 15
3 22
3 18
4 21
5 2
11 23
4 22
11 24
5 23
11 19
6 7
5 5
7 15
10 7
4 23
13 20
3 2
8 7
13 10
7 9
13 23
5 10
9 9
11 15
5 2
