13 17
#################
#############.###
#############.###
###########.#.###
########..#.#.###
######....###.###
###..#..#..##.###
#....##.#..##.###
#..#..#.#..##.###
##.#..#.#...#.###
##.#..#.##.##...#
####.....#......#
#################
11 3
5
11 8
8 11
10 6
11 15
10 3
10 5
8 10
10 12
2 14
12 9
