12 18
##################
###.##############
###.......########
###..####.########
##..##..#.......##
#..############..#
#.###.....#.####.#
#.#.#####........#
#.###...###.######
#...#######..#####
###..........#####
##################
11 8
3
3 7
9 12
7 9
7 12
7 6
2 4
