12 24
################..######
#####..#...#...####....#
##..####...#...#..#.#.##
##.........#......#.#.##
##.############...#.#.##
##.#...#..#..###.##.#.##
##.#......#..#...##...##
##.##..##.#....#.##...##
#..##.##..##.#.#.###.###
#.....#..............###
####..#############..###
#######...........######
3 11
7
9 13
10 8
3 10
7 13
4 14
3 9
3 14
10 8
3 22
7 13
2 23
2 22
4 22
6 13
