8 9
#########
#...#####
#.#.#..##
#......##
###..#..#
###.....#
###..####
#########
4 4
2
4 5
4 3
5 4
3 4
