12 14
##############
######...#...#
####........##
####.#...#...#
####.#####.###
###..........#
###...##.#..##
###...####..##
#####.##...###
##....##.....#
#............#
##############
2 11
9
5 11
4 5
11 8
3 10
6 10
7 6
10 12
9 10
8 5
6 7
5 5
6 11
11 8
6 10
11 9
9 11
3 6
9 6
