9 9
#########
##..#...#
#...##..#
#.......#
#..##..##
#......##
####...##
#......##
#########
2 6
6
4 7
5 7
7 7
6 3
3 7
5 3
8 3
8 2
7 5
8 6
8 5
8 4
