8 14
##############
###########..#
#.......#....#
#.........#..#
####.######..#
#.......#....#
#.........#..#
##############
6 2
8
7 3
3 12
4 5
5 12
4 4
6 3
3 7
6 5
4 9
4 6
7 6
4 12
6 12
7 2
3 4
6 5
