11 19
###################
##...##############
##......###########
#..#..#.........###
#..#..........#...#
#..#.#######....#.#
#..#..............#
#.........####....#
#.........#.....#.#
########..#.......#
###################
8 9
6
4 15
6 3
9 16
3 7
3 4
6 16
6 18
5 18
7 18
10 18
8 18
9 18
