7 8
########
###..###
#......#
#.#..#.#
#.#....#
#...####
########
5 5
3
3 4
3 3
3 6
5 4
2 5
3 4
