14 26
##########################
#........................#
#.................########
#################.########
##############.##.########
##############.##.########
############......########
#########...#...#.########
#########.#.#............#
#......##.#.#.#..........#
##........#.#.#..........#
###.....#.#.#.#..........#
####....#.#...#..........#
##########################
2 25
23
13 17
10 21
7 16
3 3
11 5
12 17
10 22
6 15
8 15
12 21
7 14
10 19
10 24
2 3
10 23
12 22
11 7
11 17
13 23
13 5
10 25
10 20
11 6
11 16
9 22
12 16
9 25
9 15
9 21
13 25
9 19
13 16
12 24
2 2
9 24
3 2
9 20
5 15
7 13
11 3
13 5
9 23
12 4
7 17
11 25
10 2
