11 15
###############
########..#####
########..#####
##..........###
#.............#
#.#.........#.#
#.#######..##.#
#.#.....#..##.#
#.###########.#
#.............#
###############
5 9
8
4 10
6 9
6 7
4 9
4 6
6 11
7 11
4 11
5 9
5 4
5 10
5 5
5 11
5 6
5 7
5 8
