13 9
#########
#.......#
#.##.##.#
#.##.##.#
#.......#
#.##.##.#
#.......#
#.##.##.#
#.......#
#.##.##.#
#.##.##.#
#.......#
#########
7 5
6
5 4
5 6
7 6
7 4
9 4
9 6
12 2
7 3
2 8
7 7
2 2
12 8
