13 8
########
###..###
###..###
#......#
#......#
###..###
###..###
###.####
##.....#
##.....#
###..###
###..###
########
2 5
6
6 4
11 4
5 5
4 5
3 4
3 5
5 4
11 5
5 6
10 7
9 5
3 5
