11 7
#######
#.#..##
#....##
#.#.#.#
#.....#
#.#.#.#
#.....#
#.#.#.#
#.....#
#.#.#.#
#######
3 4
4
6 4
4 4
9 4
8 4
3 5
10 6
10 4
2 2
