13 9
#########
####.####
####.####
####.####
#.......#
#.#####.#
#...#...#
#.#.#.#.#
#.......#
#.#.#.#.#
#.......#
#.#####.#
###...###
5 5
9
7 3
11 7
6 8
4 5
9 3
7 7
11 3
6 2
9 7
12 2
9 2
11 8
9 8
11 2
2 5
7 8
7 2
12 8
