9 8
########
###..###
##....##
#......#
#......#
#......#
#......#
###..###
########
7 3
8
6 4
4 6
5 5
6 6
7 6
4 4
7 4
3 4
5 4
3 5
5 5
5 6
7 4
7 5
3 4
5 3
