9 10
##########
####.#####
###...#..#
##.#.....#
#.......##
##...#.###
##.....###
####.#####
##########
5 3
5
6 4
5 4
4 5
5 6
5 7
5 5
5 2
2 5
8 5
5 8
