14 15
###############
#.#.#.#......##
#.#..........##
#.....##.....##
#...###...#.###
#...###......##
#.#.#.....#.###
#...#.#...#...#
#..##.......#.#
#..##....####.#
#..##...##..#.#
#..##...#####.#
#..##.........#
###############
13 2
3
9 9
3 11
3 6
13 9
3 4
6 13
