9 9
#########
#####...#
#.......#
#..#.##.#
#.......#
#.#.....#
#..#.#..#
#.......#
#########
5 5
7
5 4
4 5
5 6
3 8
4 3
3 6
6 5
8 3
6 8
4 8
2 8
5 7
8 7
8 5
