8 7
#######
###..##
###..##
###..##
#.....#
#.....#
##..###
#######
4 5
2
5 4
5 3
5 5
5 3
