7 8
########
###..###
###....#
#......#
#....###
#....###
########
5 5
3
4 4
4 6
3 5
4 5
3 4
3 6
