7 8
########
###..###
###..###
#......#
#......#
##...###
########
5 4
3
4 5
4 6
4 3
4 5
5 6
5 3
