6 9
#########
#.....###
#.......#
#.......#
######..#
#########
2 6
4
4 5
3 4
3 6
3 5
2 5
3 4
3 6
3 5
