8 8
########
#..#####
#..#####
#......#
#......#
##..####
##..####
########
5 2
3
4 4
4 6
4 3
5 6
5 4
5 3
