14 14
##############
####...#######
#.........####
#..#...#######
#..#......####
#..#...#######
#..#......####
#..#...#######
#..#......####
#.........####
#..####...####
#............#
#............#
##############
12 13
17
9 7
4 7
6 7
5 5
10 4
11 8
12 10
12 12
9 9
12 6
7 5
12 4
8 7
12 8
3 7
3 4
3 5
5 9
5 10
4 6
6 6
4 5
3 10
5 7
8 5
9 5
3 8
6 5
3 9
7 10
8 6
7 8
5 8
7 9
