14 14
##############
####...#######
#.........####
#..#...#######
#..#......####
#..#...#######
#..#......####
#..#...#######
#..#......####
#.........####
#..####...####
#............#
#............#
##############
12 13
22
4 7
12 12
3 7
6 7
5 5
12 6
6 3
12 10
10 9
9 7
10 4
7 5
8 7
3 5
8 3
11 8
9 9
11 3
12 4
4 3
3 4
12 8
5 9
6 6
5 6
7 7
8 5
5 8
3 10
7 6
7 10
8 6
4 5
3 9
9 6
6 5
7 9
2 7
5 10
4 6
5 7
3 8
9 5
7 8
