10 7
#######
#.#...#
#.#...#
#.....#
#....##
#.....#
###...#
###...#
###...#
#######
8 5
5
5 5
4 5
7 5
6 5
3 5
5 4
5 5
4 5
6 5
5 3
