17 24
########################
#################..#####
###############....#####
###############.#..#####
###########.....#.######
###########.#...#......#
###########.#...#.####.#
##########..#...###..#.#
#########..##...#....#.#
#########.##......#..#.#
########...#...####.##.#
########.#.....#.....#.#
#######....##.##.#.....#
#.....#.##.##....#######
#.#.....#.....#.########
#.##.####.......########
########################
16 16
14
14 11
7 14
15 13
9 14
13 14
4 18
12 12
7 18
12 19
5 14
7 16
10 20
6 15
8 15
8 14
7 15
9 15
12 13
4 18
10 16
7 18
12 19
10 20
11 14
14 14
8 16
6 16
13 11
