11 11
###########
####.....##
###.......#
###.......#
####......#
#.........#
#...##....#
#####.#..##
###########
#######..##
###########
6 3
10
6 9
4 9
6 7
4 8
5 6
3 8
3 6
7 8
5 8
3 5
5 9
4 6
6 8
4 8
6 6
7 9
5 7
3 9
3 7
3 5
