12 13
#############
#...........#
#...#####...#
#.#.......#.#
#.#.......#.#
#.#.......#.#
#.#.......#.#
#.#.......#.#
#.#.......#.#
#.#.##.##.#.#
#...........#
#############
11 10
11
6 9
4 9
5 8
4 5
5 6
7 6
8 5
8 9
8 7
7 8
6 5
5 9
6 4
9 7
5 5
4 6
4 8
6 10
7 5
8 8
8 6
7 9
