13 13
#############
#...........#
#...#####...#
#..##...#...#
#.##......#.#
#.#.......#.#
#.#.......#.#
#.#.......#.#
#.##.....##.#
#.#.....##..#
#...#####...#
#...........#
#############
11 10
12
6 9
6 7
5 8
5 6
7 6
9 8
8 5
8 9
8 7
9 6
7 8
6 5
5 9
9 7
6 8
5 5
6 6
5 7
9 5
9 9
7 5
8 8
8 6
7 9
