10 11
###########
#..#...####
#......####
#..###.#..#
#...#.....#
#...#..#..#
##..#..#..#
##.......##
##..#..####
###########
4 9
9
5 9
8 3
3 3
5 7
6 3
8 8
4 3
5 8
5 3
3 2
4 7
6 7
8 3
6 6
8 7
2 2
4 2
5 2
