9 11
###.....###
#.#######.#
#.........#
#.#.#.#.#.#
#.#.#.#.#.#
#.#.#.#.#.#
#.........#
#.#######.#
###.....###
5 4
6
6 4
4 8
6 10
7 7
4 2
3 5
8 2
7 6
8 10
2 10
3 6
2 2
