9 7
#######
###..##
###..##
#.....#
#.....#
#....##
###..##
###.###
#######
4 6
5
6 4
5 4
4 4
7 4
3 4
6 4
5 4
4 4
7 4
8 4
