10 14
##############
#######.....##
######.......#
#####...#.#..#
#............#
#.......#.#..#
#####........#
######.......#
#######.....##
##############
4 12
10
4 7
3 12
5 5
6 7
5 12
7 9
8 10
3 9
7 11
5 3
5 9
4 10
5 10
8 13
3 13
5 11
6 10
5 13
2 10
6 2
