8 9
#########
#...#...#
#..#.#..#
#.......#
#..#.##.#
#.......#
#.......#
#########
5 5
3
3 7
6 7
3 3
2 8
7 2
3 5
