8 9
#########
#...#...#
#..#.#..#
#.......#
#..#.#..#
#.......#
#.......#
#########
5 5
8
6 4
6 7
3 3
4 8
4 4
5 7
3 7
5 3
2 7
2 6
2 8
4 2
7 8
2 4
7 2
3 5
