9 13
#############
#.....#.....#
#....#.#....#
#...#...#...#
#..#.....#..#
#.#.......#.#
#...........#
#...........#
#############
3 11
11
7 3
3 10
2 11
5 2
7 7
7 5
7 10
6 12
3 4
2 4
4 11
4 10
2 6
4 6
8 2
4 8
8 12
2 8
6 10
3 9
3 7
3 5
