7 13
#############
#...........#
#...........#
#.#.##..#.#.#
#...........#
#...........#
#############
3 10
8
4 10
4 7
3 3
4 8
4 4
3 11
3 9
3 6
2 7
2 6
2 9
2 8
2 3
2 2
2 5
2 4
