6 6
######
#....#
#....#
#.#..#
#....#
######
4 5
3
4 4
3 3
5 3
2 5
5 2
3 2
