6 6
######
#....#
#....#
#.#..#
#....#
######
4 5
3
4 4
3 3
5 3
3 2
2 3
5 2
