6 6
######
#....#
#....#
#.#..#
#....#
######
3 4
3
4 4
3 3
5 3
4 2
5 5
2 4
