9 10
##########
####...###
#.......##
#....#...#
#........#
#........#
####...###
####...###
##########
5 7
9
4 7
3 3
6 8
4 5
5 6
6 3
7 5
3 6
5 3
2 7
5 9
3 2
6 9
4 9
3 8
8 7
2 5
5 2
