15 15
###############
####....#######
####.##..######
###...#..#..###
###...#.......#
#####.##.#..#.#
####.....##.#.#
#....#.#.#..#.#
#.#.##........#
#.#..#.##.#####
#...........###
###..#..#...###
######..##.####
#######....####
###############
12 10
12
5 10
10 10
5 12
9 8
12 7
11 3
8 9
8 7
9 4
7 8
11 6
3 5
9 7
4 6
6 11
10 7
9 8
7 7
9 9
8 9
7 5
8 7
7 8
7 9
