17 18
##################
####..############
####........######
####..####..######
###...#..#...#####
###......#......##
###....#.##..#..##
###.####..##.#..##
###.#.....#.....##
###.#..#.....#..##
##...#.###.####.##
##.....#...#.....#
#..........#.....#
#...##.#####.....#
#####............#
#####............#
##################
8 15
28
15 13
14 13
4 12
7 16
12 16
6 14
5 5
13 3
5 12
7 6
12 6
15 11
14 14
15 15
9 14
11 4
12 14
13 15
9 16
15 7
13 10
3 5
9 13
6 8
14 16
9 9
12 4
15 9
6 6
5 6
14 4
9 8
13 4
8 9
12 5
5 5
11 5
13 3
7 6
8 10
12 3
10 9
11 4
13 2
4 5
9 10
7 5
14 2
6 5
4 6
10 10
9 9
11 3
13 5
12 4
14 3
