9 8
########
##..####
#......#
#...#..#
#...##.#
#....#.#
##.....#
###....#
########
4 6
5
3 5
4 4
7 4
4 3
5 3
6 7
7 6
7 7
8 7
8 6
