15 22
####.............#####
#..###############...#
#......#.............#
#.##.....####..#...#.#
#.#....#....##...#...#
#.#.#.##.##.#...##.#.#
#.###.#.....#..##....#
#.....###########....#
#.#.#..#......##..#.##
##.....#....#.......##
###..#.#.####.#.#.####
####........#.....####
#####...#......#######
##########.....#######
######################
13 13
10
11 16
10 5
5 16
10 17
4 15
5 20
9 4
9 6
3 16
8 5
14 11
6 9
4 8
7 9
14 13
14 12
14 15
14 14
7 8
6 14
