13 14
##############
#..###########
#.........####
#..#####...###
#....#......##
#....#..#....#
#.#..#..##...#
#....#..###..#
#.........#..#
####.#.#....##
####.......###
####....######
##############
6 3
4
3 8
5 9
9 12
6 11
12 5
12 7
11 6
12 8
