13 18
##################
#.......#........#
#.#...#.....#..#.#
#...#....#.##....#
#..###...#..##.#.#
#...#...##..#....#
#......##...#....#
###.##.#....#..###
###....######..###
###............###
####..######..####
####..........####
##################
8 9
6
7 15
3 10
4 16
5 15
7 16
6 16
3 12
3 10
4 15
8 10
8 9
7 10
