13 19
###################
###......#..#######
###...#..#..#######
###...##.....#....#
###..##...#.......#
###...#..###......#
#.........#..######
#...##........#####
#..##.........#####
#...#..############
#......############
###....############
###################
2 7
5
6 4
5 5
11 5
9 3
7 5
5 16
5 17
4 17
5 18
6 17
