16 15
###############
#..........####
#..........####
#.#.##..##.####
#.#.##..##.####
#.......##.####
#...##..##..###
###..##.....###
##....##..#.###
###....##.....#
####....##....#
#####....##...#
######....#####
#######.......#
########...#..#
###############
15 14
6
11 7
14 10
10 6
13 9
9 5
12 8
12 14
12 13
10 13
10 14
11 14
11 13
