9 22
######################
#....................#
#.........#..#.#.#.#.#
#.##.###..#.##.......#
#.##..#..##....#.#.#.#
#.......##..##.###...#
#....................#
###..#####..#####..###
######...####...######
4 10
6
4 18
5 19
5 14
4 16
6 20
4 20
4 10
5 9
6 7
4 9
6 8
5 8
