12 9
#########
####....#
###.....#
#....##.#
#.....#.#
#.##..#.#
#.##.##.#
#....#..#
#.#.....#
######..#
######..#
#########
3 7
4
4 5
8 3
9 6
5 3
10 7
10 8
11 7
11 8
