20 30
##############################
#...#.....#.....#.....#......#
#...#.....#.....#.....#......#
#...#..#..#..#..#..#..#..#...#
#...#..#..#..#..#..#..#..#...#
#...#..#..#..#..#..#..#..#...#
#...#..#..#..#..#..#..#..#...#
#...#..#..#..#..#..#..#..#...#
#...#..#..#..#..#..#..#..#...#
#...#..#..#..#..#..#..#..#...#
#...#..#..#..#..#..#..#..#...#
#...#..#..#..#..#..#..#..#...#
#...#..#..#..#..#..#..#..#...#
#...#..#..#..#..#..#..#..#...#
#...#..#..#..#..#..#..#..#...#
#...#..#..#..#..#..#..#..#...#
#...#..#..#..#..#..#..#..#...#
#......#.....#.....#.....#...#
#......#.....#.....#.....#...#
##############################
12 15
2
12 3
4 3
12 28
4 28
