22 27
###########################
###################...#...#
#...........##....#.......#
#..#...##..##.....###..#..#
#.##...#..##....#...#..#..#
#........##....##.#.#.##..#
####....##....##....#..#..#
###....##....##....##.##..#
##....##....##....##...#..#
#....##....##....##....#..#
#...##....##....##....##..#
#..##....##....##....##...#
#..#....##....##....##....#
#......##....##....##..#..#
#.....##....##....##...#..#
##...##....##....##.##....#
###.##....##....##.....#..#
#####...###....##...##.#..#
#####.........##.....###..#
#######......##...........#
##############............#
###########################
18 23
5
6 7
6 6
5 6
7 6
6 5
18 23
16 23
17 21
17 22
17 23
