15 20
####################
#......#############
#..#...#############
#......#############
#..#...#############
#####..#############
#####..#############
#####..#############
#####..............#
#####..............#
##############.#####
#########........###
#########........###
############.#######
####################
14 13
6
4 6
7 6
5 7
8 7
9 6
3 5
3 2
14 13
2 3
4 3
2 2
4 2
