16 19
###################
#######...........#
#######...........#
#####.............#
#####..##...#.###.#
#####..#..###.#.#.#
#####.##........#.#
#####.....#.....#.#
##..#.....####....#
##......#....#...##
#.....#.#..#....###
#...#...####...####
#.#.##.##.....#####
#.#.#..#......#####
#......#...########
###################
15 3
20
8 13
13 13
3 11
11 14
3 14
4 9
9 15
10 7
11 5
10 12
4 13
3 16
7 14
5 11
7 9
11 8
4 15
4 17
11 3
8 8
14 4
13 4
14 9
12 2
13 12
15 11
15 4
12 3
13 11
14 10
13 2
15 3
15 10
14 2
13 10
14 11
15 2
14 12
12 4
15 9
