11 14
##############
######..#....#
#....####....#
#.#....#..##.#
#...#........#
#.........##.#
#...#####....#
#...#...#....#
#...#...######
##.###########
##############
10 3
9
6 9
3 12
6 7
5 6
7 12
5 12
9 3
7 10
5 3
10 3
5 4
8 3
9 2
6 3
7 4
9 4
5 2
7 2
