12 13
#############
#........####
#..#####.####
##..#..#.####
#..##.....###
##.....#...##
#..#.###.#..#
##.....#...##
###..#.....##
####.....#.##
########...##
#############
7 12
7
4 9
5 6
6 10
8 10
8 9
9 10
10 9
2 7
2 6
3 3
2 8
2 3
2 5
2 4
