14 15
###############
#########.#.#.#
##......###...#
##......##....#
###.###.###.#.#
##...#..##....#
##.#.#.......##
####....##..###
###..####..####
#......#....###
##..#.##...####
#......#..#####
###...#########
###############
13 5
8
5 4
11 10
10 11
4 6
7 12
5 12
7 7
4 13
12 2
10 5
10 7
12 7
13 4
12 5
13 6
10 2
