8 11
###########
#......####
#..##..####
#...##...##
#....#....#
###.......#
###..######
###########
5 2
4
5 9
5 7
3 3
4 8
7 4
6 4
7 5
5 5
