10 9
#########
####...##
#......##
#....#..#
#....#..#
#..#....#
#..#.#..#
##...#..#
###.....#
#########
8 3
8
5 4
6 6
4 5
5 7
4 3
3 6
3 4
5 3
9 8
8 8
9 4
8 7
9 6
9 5
8 5
9 7
