10 10
##########
##...#..##
###.....##
##...#..##
##..##.###
#####....#
#........#
#......###
#...######
##########
9 2
6
8 3
5 7
7 7
7 4
3 6
8 5
6 9
5 4
6 8
4 4
4 3
7 9
