10 10
##########
######...#
#####....#
####....##
###....###
#.....####
#....#####
#...######
#..#######
##########
3 9
5
6 4
7 3
5 5
4 6
3 7
8 2
9 2
9 3
6 2
7 2
