12 10
##########
#.......##
#.##....##
#..#.##.##
##......##
##.#######
#..#..#.##
#.......##
####.#.###
###..#...#
###......#
##########
11 6
3
4 5
5 4
3 6
8 6
11 7
11 5
