9 13
#############
###.......###
#...........#
#.#...#...#.#
#.#..###....#
#.....#.....#
###.......###
#####...#####
#############
6 3
10
5 4
6 9
4 9
3 3
5 10
4 5
7 7
3 9
3 7
6 5
4 10
5 9
4 6
5 5
4 8
5 11
6 6
6 8
3 11
4 12
