10 12
############
#######...##
##.........#
##..####...#
###.#..##..#
#.......##.#
#....#...###
##.#.......#
####.....###
############
8 11
6
5 4
6 6
7 7
8 10
7 5
8 6
4 10
5 10
5 11
6 11
3 11
4 11
