10 10
##########
#..#######
#..#######
#.....####
#....#####
#..#...###
##.#.#..##
##.......#
######...#
##########
4 6
4
5 4
7 5
3 3
6 6
8 9
9 8
9 9
9 7
