9 12
############
#......#####
#..#......##
#.###.....##
#.....###.##
#..#...#...#
#..........#
#......#####
############
7 11
4
6 3
7 4
5 4
6 5
6 11
7 11
6 10
5 10
