13 11
###########
##.....####
##.#.#.####
##.....####
##..#.##..#
###.......#
#...#.#.#.#
#...#.....#
#..####.#.#
##........#
##..##....#
###....####
###########
4 7
4
8 9
8 3
11 9
10 5
4 5
4 7
5 6
4 6
