9 11
###########
####..#..##
####......#
###...#...#
##....##..#
#...#.....#
#...#....##
#...#######
###########
6 10
3
6 4
7 7
7 3
6 8
7 7
6 6
