8 9
#########
######..#
#####...#
####....#
###....##
#.....###
#....####
#########
7 2
4
3 7
5 5
6 4
4 6
6 3
7 3
6 2
7 2
