11 14
##############
##..##########
##......#....#
##.#.#.......#
#....#..###..#
#.##.##...####
#..#.#....####
#.......######
#..#....######
#..###########
##############
8 4
4
8 6
8 8
4 9
7 9
9 2
9 3
10 3
10 2
