12 14
##############
####....######
####.##.######
#............#
#.....#...##.#
#...#...###..#
#..#..#......#
#....#########
##.#.#.......#
##...........#
###########..#
##############
11 13
6
5 9
6 7
5 5
9 3
6 3
8 4
9 13
10 13
10 12
11 12
9 12
11 13
