11 14
##############
#####......###
##..........##
##..##.#.#..##
#...#..#.....#
#......####..#
#....#.#.....#
######.......#
######......##
##########..##
##############
8 13
4
6 3
6 5
5 4
4 3
8 9
8 11
9 8
9 10
