14 14
##############
####..########
#...........##
#.##.#..#.#.##
#....#....#.##
#..#.#.#....##
#.##.....#####
#..#.#####..##
#....#......##
####.#.#....##
###..###.#...#
###..........#
#########..###
##############
12 13
6
4 10
5 4
3 3
4 8
3 9
5 8
10 11
10 10
12 13
10 12
11 12
11 13
