13 14
##############
######......##
####........##
###....###..##
###......#..##
######.#....##
###..#.#...###
#....#...#.###
#.#..###...###
#..........###
##...#...#...#
####...#...#.#
##############
12 13
5
4 6
5 5
3 9
8 8
3 7
8 3
7 4
9 4
8 5
8 4
