12 25
#########################
##.#...#.#......#..##..##
##...#.....#.#.#.#......#
##.##.#.##.....#.....#.##
#.......#...##.....#....#
#...#.#...#....#.#..#.#.#
##.#.#......#....##.....#
##.#...#.#.....#....#.#.#
##....#...##.##.#.#...#.#
##.#..............#.#.#.#
##....#.#...#..##.......#
#########################
2 3
1
3 3
11 24
