6 7
#######
##....#
#.....#
#.....#
##....#
#######
5 5
4
4 5
4 4
3 4
3 3
4 6
5 5
2 4
3 5
