6 7
#######
###...#
##....#
#....##
##...##
#######
5 4
4
4 5
4 4
3 4
4 3
4 2
5 5
2 4
3 3
