7 10
##########
##..######
##..######
#........#
#........#
#####..###
##########
5 4
4
5 6
5 5
4 6
4 3
3 4
2 3
2 4
4 3
