6 7
#######
##.#..#
#.....#
##....#
###...#
#######
3 2
3
4 4
3 3
3 5
4 5
2 5
2 3
