14 26
##########################
#######............#######
#######...##..##...#######
####..................####
####.##.#.##..##.#.##.####
####.##.#.##..##.#.##.####
#........................#
#........................#
####.##.#.##..##.#.##.####
####.##.#.##..##.#.##.####
####..................####
#######...##..##...#######
#######............#######
##########################
7 2
12
4 10
11 10
11 17
12 14
3 13
12 13
4 17
7 18
8 9
8 18
3 14
7 9
8 14
7 14
9 13
8 13
7 15
9 14
8 12
7 12
7 13
6 13
8 15
6 14
