12 24
##########......########
###..#...##...###.....##
##....#...##..#.#.....##
#..##..#...####.#.##...#
#.###......#.......#.#.#
#...#................#.#
#.......#######..#...#.#
#..####.#.###.#.###....#
##.####....#....######.#
#....#....###....#...###
#....#...##.##...#######
##########...###########
6 12
5
7 3
10 4
4 18
6 21
6 14
8 14
9 13
8 10
9 11
6 15
