8 7
#######
####..#
###...#
###...#
#.....#
#..#..#
#....##
#######
7 2
3
4 5
6 5
5 3
4 5
2 5
3 5
