7 7
#######
#.....#
#.....#
#.#..##
#....##
##...##
#######
2 4
4
4 5
2 3
3 3
3 5
4 2
2 5
2 3
2 4
