11 24
########################
##......################
#.......################
#..#.#.....#.#.........#
#.......##.#...........#
#..#.####..#.#.#....#..#
#......##.##...#.####..#
#.......########.#..#..#
####.............#.....#
######...........#.....#
########################
7 10
6
8 3
5 5
5 14
6 3
8 17
5 3
9 20
10 19
8 20
4 13
8 19
9 19
