8 11
###########
#.#.......#
#.#.......#
#.........#
#.#.......#
#.#####.###
#.........#
###########
5 10
9
2 7
4 10
4 7
4 9
4 6
6 8
4 8
5 6
3 6
2 9
2 8
3 10
2 10
3 8
3 9
7 10
3 7
7 9
