8 10
##########
#####....#
#####....#
#####....#
#........#
#........#
#........#
##########
2 6
8
5 9
4 7
6 4
6 7
5 6
5 7
6 3
6 5
2 7
2 6
2 9
2 8
3 8
3 9
3 6
3 7
