14 26
##########################
#........................#
##........#....#........##
#.#........#..#....##..#.#
#..#####...#..#...#..##..#
#.......#........#.......#
#........#......#..###...#
#.#.###...##..##..#......#
#.#...#....#..#.....##...#
#......#......#..#.....#.#
#.#....#.###.###.##.#....#
#.#..#.#.........#..#.##.#
#......#.###.##..#.......#
##########.###############
3 4
20
4 7
8 13
7 12
3 21
3 17
6 14
12 13
3 10
3 13
6 11
3 23
5 17
10 13
12 7
3 9
3 19
3 5
3 8
5 14
6 16
10 6
11 23
10 21
9 4
11 5
10 7
11 22
9 24
10 22
11 4
10 4
10 23
9 6
12 22
11 7
10 5
9 23
9 5
11 6
8 4
