14 25
#########################
############.......##...#
############.#.###....###
####.........#....#######
#....#########.##.....###
#.##...........##.###..##
#.###############......##
#.########..######..##.##
#.......##......#..#...##
#.####......#.#.#.##....#
#.#.#...#####.#.#.###.#.#
#.#.#.#.#...............#
#.#.#.....##..########..#
###.###########......####
2 24
5
8 23
2 17
11 22
8 19
9 12
12 2
2 19
13 2
11 2
13 10
