14 21
#####################
#..#................#
#.#..##.#######.#...#
#.#.##........#.#...#
#.#.##.##.#.#.#.##..#
#.#....##.#.#.#.##..#
#.#.###..........#..#
#...###.#########..##
##.###..#########.###
##...#.#.......##.###
####...#.#####....###
#####.#..#...########
#####...#############
#####################
2 3
7
4 10
4 19
7 12
6 10
5 19
5 14
3 19
7 14
3 20
4 14
2 20
5 20
4 12
7 10
