13 19
###################
##.################
##..............###
##.###########.#.##
##.##..#######.#.##
##.#........##.#.##
##.#........##.#.##
##.##..###..##.#.##
##.#######..##.#.##
##.#####....##.#.##
#...........##....#
##############.####
###################
8 7
14
7 8
10 3
11 7
11 16
10 11
6 8
10 17
6 6
6 11
7 12
4 15
11 11
9 11
3 4
11 10
12 15
10 10
6 11
7 12
11 2
11 8
4 17
11 9
2 3
3 16
6 12
11 18
10 9
