14 26
#########.....############
#.......#######....#######
#...#...#..........#######
#.#..##.#..........#######
#.......#.######.......###
#..#.#..#......#.#.#....##
#.........###..#...##....#
#.........#.#....#.###...#
#..#.#..#.#...####....#.##
#.......#.#.####...##...##
#.##..#.#.#.#.....##.....#
#...#...#......##.##..#.##
#.......######....###....#
#########....######.######
8 12
19
4 18
13 4
11 23
8 5
6 14
6 7
4 19
12 13
12 6
11 22
6 3
8 15
9 7
2 6
9 3
7 5
10 23
4 17
3 4
4 8
2 8
11 2
3 11
3 17
3 10
4 10
13 2
3 13
10 19
13 6
3 19
4 2
6 5
3 12
11 8
3 18
9 5
2 4
