14 26
####.......####......#####
#..#...#####..########...#
##.#####.........#..##.#.#
#..#..##..##..#.....##.#.#
#.....###.##.....##.##.#.#
#####.#...######.##.##.#.#
#...#.#.......##....##.#.#
#.....##.####.#####.##.#.#
##.#...#......##..#..#...#
##.#...#..######.....#.#.#
#..######.#..###.##......#
#.........#......#..##.###
########..#............###
##########################
2 2
4
9 24
12 14
3 3
9 25
2 23
12 23
13 12
2 25
