14 25
#########################
#.#....#...............##
#.#.###.................#
#.#.#.#................##
#...#.#.................#
#.#.#.#................##
#.#.#.#.................#
#.#.#.#................##
#.#...#.................#
#.#.#.#..#.............##
###.###..#..............#
#.#......#.............##
#...######..............#
#####....################
2 2
26
3 15
5 9
6 9
10 17
3 11
11 23
8 19
5 23
3 14
4 9
8 20
10 18
8 16
7 23
3 13
3 23
10 19
3 9
8 17
7 9
13 23
3 12
10 16
9 23
8 18
10 20
8 9
7 16
9 18
11 24
12 9
3 24
3 10
6 10
7 24
9 17
7 10
3 16
9 24
10 9
4 10
9 20
13 24
11 9
5 24
4 16
9 16
5 10
5 16
9 9
9 19
6 16
