14 26
#####.......##############
#...#########.......#....#
#.#.........#.#####......#
#.#.#######.#.#...#.####.#
#.#.#.....#.#.....#.#....#
#.#.#.###.#.####.##.####.#
#.#.#...#.#..#...#..#....#
#.#.###.#.##.#...#..###..#
#.#...#.#..#.###.#..#.#..#
###.###.##.#...#.####.####
#.....#..#.###.#.........#
#.######.#...#.#.#######.#
#........#####...#.......#
##########...#############
12 13
15
8 25
8 16
3 2
8 24
13 24
11 5
4 17
9 5
8 20
8 19
7 16
10 22
2 24
5 23
7 23
9 24
7 15
9 20
11 6
9 2
4 18
9 22
2 25
13 19
5 22
7 22
9 19
9 6
9 25
8 15
