8 13
#############
#####..######
####......###
#.........###
#...........#
###.........#
####....#####
#############
4 8
7
4 7
6 8
5 11
5 6
3 9
3 6
4 3
2 7
4 10
4 6
5 7
7 5
6 12
5 3
