12 9
#########
##.######
##...####
##.#.####
#.......#
#.......#
#.......#
#.......#
####.#.##
####...##
######.##
#########
5 5
4
6 3
7 3
6 7
7 7
11 7
7 5
2 3
6 5
