8 9
#########
#...#####
#..######
#..######
#.......#
#...###.#
#.......#
#########
5 8
3
6 4
5 5
4 3
2 3
2 4
2 2
