10 22
######################
#.........##.........#
#....................#
##..#.#........###..##
##....#........#....##
##....#........#....##
##..###........#.#..##
#....................#
#.........##.........#
######################
5 12
12
6 18
5 10
5 5
6 10
5 18
5 13
3 18
8 18
6 13
8 5
6 5
3 5
5 10
5 11
6 11
7 12
5 12
6 10
5 13
4 12
6 13
7 11
6 12
4 11
