13 20
####################
##.#################
#...#...###....#####
#...#...#.######...#
##.##...#..........#
##.######..#########
#.........##########
####..##############
####.###############
####..##############
####..##############
####..##############
####################
2 3
3
5 18
3 3
11 5
4 10
4 2
7 2
