14 26
##########################
#.......#...#..#...#.....#
#..##....................#
#.........#....#...#.....#
#........................#
#..####.#...#..#...#.....#
#..#..###................#
#..#....####..#####.#.#.##
#..##############.#......#
#...............#.#.#.#.##
#...............#........#
#...............#.#.#.#.##
#...............#.#......#
##########################
13 16
23
10 15
9 18
11 10
8 24
10 7
11 22
8 20
11 4
8 2
13 2
13 15
3 9
5 15
6 23
12 11
8 3
12 15
8 22
13 18
4 3
2 15
11 15
2 4
3 15
3 25
10 11
11 2
13 4
13 8
9 18
9 25
13 25
2 23
2 2
12 10
11 18
5 4
13 2
2 3
4 25
11 12
10 14
13 18
2 15
11 25
10 2
