14 26
##########################
#..............#.........#
#...##...#.#.#.#.#.#.#...#
#..##........#.#.#.#.#...#
#.##.....#.#.#.#.#.#.#...#
###..##..#.#.............#
#....#...#.#.#.#.#.#.#...#
#........#.#.#.#.#.#.#...#
#........................#
####.####..#.#######.###.#
#.......#................#
#.##.####...########.###.#
#........................#
##########################
5 11
26
13 22
13 4
3 11
8 19
11 24
7 11
8 5
3 3
4 19
11 22
3 4
11 18
13 20
8 15
3 2
13 24
8 21
13 6
8 7
8 17
4 15
4 17
11 20
13 18
4 21
7 8
3 11
7 7
11 23
11 24
11 19
2 19
4 19
2 15
8 6
3 4
13 20
13 24
13 6
13 19
2 17
13 23
6 8
2 21
4 15
2 11
4 17
11 20
4 3
4 21
13 9
5 2
