8 8
########
#......#
#.#..#.#
#.##.#.#
#.#....#
#.##.#.#
#......#
########
5 2
2
5 5
3 5
4 5
5 4
