13 25
#########################
#......................##
######################.##
#......................##
#.#######################
#.......................#
######################..#
#...................###.#
#.#.###.###.###########.#
#.#..................##.#
#.####################..#
#......................##
#########################
2 2
4
6 17
8 13
10 5
10 17
10 21
6 24
10 17
8 20
