10 12
############
#.....######
#.......####
###.....####
#.......####
#.........##
##..#......#
######.....#
#######....#
############
2 2
11
6 9
6 7
3 3
8 10
6 3
6 5
3 6
3 7
3 4
5 8
7 9
7 3
2 6
5 6
4 4
6 10
3 8
7 4
6 2
7 11
7 8
6 5
