14 26
#########..####..#########
#.......####..####..######
#.......#.....#.....######
#.......#..#..#..##.######
#..........#.....#..##..##
#.......#..####..#......##
#.##########..#########.##
#....##########.....###.##
###...........#######....#
##...#....#........##....#
##......#....##........###
#..#########....##########
#..........###############
##########################
4 5
12
5 4
3 3
4 6
5 5
4 4
5 7
3 8
3 6
5 3
3 7
3 4
3 5
8 3
13 3
13 11
13 4
13 5
13 6
13 7
13 8
13 10
13 9
8 5
8 4
