13 26
##########################
###...........############
##..####.####.############
##.##..#.#..#.############
##..##.#.#..#.############
###..###.####.############
####.....................#
#.....................####
#############.####.##..###
#############.#..#.###.###
#############.####.##..###
#############.........####
##########################
7 6
8
5 9
8 13
7 15
7 13
8 10
8 8
7 10
9 19
4 9
8 2
8 12
7 12
8 11
10 19
7 25
7 11
