13 26
##########################
#...................#...##
#..........#............##
########......#....#.#..##
#...........#....#.###..##
#.........#........##...##
#.#..#..#..........#######
#.#..#..#.#....#........##
#.#..#..#..........#######
#.#..#..#...............##
#.#..#..#..#######.#######
#.#..#..#........#.......#
##########################
12 25
37
3 15
5 9
10 11
10 17
2 8
3 11
7 7
3 21
5 19
10 15
4 12
9 4
6 17
3 17
6 14
6 10
10 12
7 19
9 17
8 15
9 7
4 10
7 14
2 6
11 4
4 14
2 10
3 19
6 12
9 13
11 7
8 12
4 17
7 4
8 18
9 19
6 16
8 23
5 6
11 2
10 21
6 24
5 23
7 2
3 24
12 2
8 24
3 3
5 5
4 23
12 17
4 24
6 22
2 2
3 4
10 22
3 2
5 4
8 2
3 23
8 21
5 24
10 24
2 3
6 23
10 23
5 3
9 2
8 22
5 7
10 20
5 2
2 4
10 2
