14 25
##########..#############
#........####...#########
####.......##...........#
#.......#..##..#...##.#.#
#...........##....##....#
#....#..#....##..##....##
#......###....####....###
#.....#####....##....####
#....##...##.........####
#...##.....##......######
#..##.......##..........#
#...........##...##.###.#
#...#.......#######.....#
#############.....#######
5 6
36
11 16
7 3
4 7
4 8
6 21
8 19
12 9
7 20
8 14
10 8
11 10
6 7
5 5
12 20
9 15
6 3
3 6
5 22
12 10
11 18
12 8
9 3
7 5
12 11
6 12
11 7
4 6
5 16
10 10
10 16
5 7
7 13
11 3
3 8
4 3
8 4
7 21
8 13
7 12
6 21
10 15
8 19
4 22
7 11
5 23
3 14
7 20
8 14
9 15
5 12
6 10
8 20
7 19
6 22
5 22
7 14
9 14
5 11
6 11
4 14
5 21
6 12
2 14
9 13
5 10
8 12
10 16
7 13
6 20
10 14
8 18
6 13
