11 14
##############
####...#######
####...#######
#####.########
#####.#..#####
###.#.####.###
#.......##.###
#.##.........#
#....#.....###
##......######
##############
9 5
7
6 4
2 6
8 12
9 2
7 6
8 7
7 11
6 4
8 13
5 6
6 11
9 2
8 6
2 5
