14 25
#########################
#........##......########
#.###.##.#..####...##...#
#.....##...##.......#.#.#
#####.####.###....#.#.#.#
###...####..##.##.#.#.###
###.............#.#.....#
####.####....##...#..##.#
#.......#.....#.##..###.#
#....##.#........#.#....#
#.##.##......###........#
#.#####.##....###....####
#........#...##.##...####
##############...########
10 24
16
10 5
11 21
13 3
6 11
4 18
9 3
10 19
7 4
9 10
7 5
2 3
7 16
3 6
4 24
7 11
11 18
10 5
2 6
9 14
2 9
10 10
11 5
4 18
10 19
9 5
5 24
12 19
7 4
7 16
13 9
13 19
7 11
