14 11
###########
##........#
##........#
##..#..#..#
##........#
##........#
##........#
##..##...##
##..##....#
###.......#
##........#
#.....#...#
##........#
###########
10 8
11
6 4
5 10
6 6
11 5
3 9
8 8
12 9
9 4
3 4
5 8
12 8
2 7
2 6
2 9
13 3
2 8
2 10
13 7
2 3
2 5
13 10
2 4
