14 26
##########################
#.................########
#.#..#.#...#...........###
#....#....#.#...#..#.#####
#.........#........#######
##.#.....#..#..##..#######
##.#..#..#...#..#..#######
##..#...#..#.#........####
##.###........##..#...####
#..###.#......#....#...###
#....###........###......#
##...##........#.###...###
#..#####.#.###...#.##...##
####...#####.#####..######
2 9
15
2 7
9 7
6 9
5 6
3 10
10 12
3 9
3 19
7 11
3 7
12 23
2 14
10 9
5 8
5 3
6 9
13 3
5 6
3 23
3 10
10 7
12 12
11 23
3 9
12 11
2 2
2 15
3 7
12 9
5 8
