14 26
######...#################
#....#####.###############
##.........###############
##...#####.#..############
###.##...#.#..#..........#
##...##.##.#..#.##########
##....###..####.##########
#.........#.....##########
##....###...###.##########
##...##.##.##.#.##########
###.##...#.####..........#
##...#...#...#############
#....#...#.#.............#
######...#################
8 16
9
6 4
11 17
10 11
10 4
6 11
5 17
3 10
13 14
8 6
13 2
8 2
13 25
2 11
5 25
3 6
2 2
11 25
13 11
