13 25
#########################
######..#............####
#.........###...#.....#.#
#............#.#.##.###.#
##..###......#....#.##..#
##..###...#......#...#..#
##...##...#.#.......##..#
##...........###....#...#
##.....##...#..#..#.#...#
##.....##...............#
#########.#...#...#######
#########....#...########
#########################
10 24
22
7 3
6 9
12 12
8 9
2 12
3 7
6 14
2 19
7 24
7 23
4 10
5 11
4 5
9 10
5 15
3 19
9 6
4 11
10 14
8 18
4 3
8 4
11 16
8 13
2 8
6 21
2 12
12 16
5 23
3 14
3 24
3 10
5 18
12 17
12 10
11 18
9 20
2 10
2 17
2 7
12 15
11 17
3 22
4 17
