14 20
####################
#########..........#
#########..#.#.#.#.#
#########..........#
#######...##.#.#.#.#
#######............#
#######.#.###.#.#.##
####..#.#.........##
#..#.##.##..#.#.#.##
#..###...##.......##
#........###########
#..................#
########...........#
####################
5 8
19
6 9
8 13
4 18
12 12
12 5
4 12
12 16
10 3
12 10
12 3
8 15
12 14
6 11
12 7
4 14
4 16
12 18
8 17
7 8
12 12
12 16
6 17
6 14
12 13
12 17
12 10
6 15
6 18
12 14
6 11
12 18
12 11
6 12
6 19
12 15
12 19
6 13
6 16
