12 12
############
#...#.##...#
#....#.....#
#..........#
##...#...###
#.#....#.#.#
##..#.....##
##....#...##
#..........#
#....#.....#
#...#.##...#
############
4 7
12
7 3
2 6
3 3
10 10
6 11
10 7
3 10
6 2
7 10
3 7
10 3
11 6
7 3
2 6
6 7
6 6
6 11
10 7
7 6
7 7
6 2
7 10
3 7
11 6
