11 15
###############
############.##
############.##
#########..#.##
#.......####.##
#.....####...##
#####....#....#
#####..#.#..###
########.#..###
########....###
###############
5 2
3
5 7
9 12
3 13
2 13
7 14
5 8
