14 26
##########################
#.#.#.#.#.#.#.#.#.#.#.#.##
#.#.#.#.#.#.#.#.#.#.#.#.##
#.#.#.#.#.#.#.#.#.#.#.#.##
#.#.#.#.#.#.#.#.#.#.#.#.##
#.#.#.#.#.#.#.#.#.#.#.#.##
#.#.#.#.#.#.#.#.#.#.#.#.##
#........................#
##.#.#.#.#.#.#.#.#.#.#.#.#
##.#.#.#.#.#.#.#.#.#.#.#.#
##.#.#.#.#.#.#.#.#.#.#.#.#
##.#.#.#.#.#.#.#.#.#.#.#.#
##.#.#.#.#.#.#.#.#.#.#.#.#
##########################
8 2
24
7 12
7 16
9 25
7 2
7 20
9 15
9 21
7 6
7 24
9 11
9 17
7 10
9 7
7 14
9 3
7 18
7 22
9 13
9 9
9 23
7 4
9 5
9 19
7 8
13 13
2 18
2 8
13 17
2 22
2 12
13 21
13 3
13 25
13 7
2 2
13 11
2 16
2 6
13 15
2 20
2 10
13 19
2 24
2 14
13 23
13 5
13 9
2 4
