14 25
#########################
##########...############
##########...#..#.#.#####
######..........#.###...#
######...##.###.#.......#
##..................##..#
##..###.###########.##.##
###.#.#.#.........#....##
#.#.#.#.#.......###.##..#
#.#.#.#.##......#.#.....#
#.#.###..#......#.#.##..#
#........#......#...#####
###..#####......#########
#########################
5 8
5
6 18
3 12
6 20
10 23
12 8
4 7
12 20
6 24
10 23
6 5
