14 26
###################.######
#.................###....#
#..#.....................#
#..#####.####.######.###.#
#..#..##..#........#.#...#
#......#..#..###...###...#
##.....#..#..#...........#
#####.##.##....##.####...#
#............#...........#
#....#....#..#..#...#.####
#....#.......#..#...###..#
#....#....####.##........#
#....#..............#....#
##########################
3 7
30
3 25
7 21
13 13
3 21
8 9
12 5
7 16
6 24
8 14
11 10
12 2
4 9
3 3
9 21
7 6
13 16
6 25
12 3
9 7
12 21
3 2
12 25
4 14
11 7
12 4
8 18
13 9
4 21
9 5
12 8
7 3
7 21
13 13
2 18
13 4
3 21
5 19
8 9
6 2
13 8
8 14
11 10
4 9
13 3
9 21
13 25
13 16
5 25
13 7
9 7
8 25
12 21
13 2
12 7
4 25
5 21
13 5
8 18
9 5
5 2
