14 26
##########################
#..............#.........#
###...#.#...#..#.#..###.##
####.##.#........#..#.#..#
#.......#...#..#.#..###..#
#..####.#...#..#.#....#..#
#..#....#...#..#.##......#
#..##.###..##..#..#...##.#
#...........#.........#..#
##..........#..####...#.##
###....##...#....#.......#
###...#..........#.......#
#.....#.....#....#.......#
##########################
13 8
28
12 12
7 7
6 21
7 25
2 22
12 16
13 21
7 20
11 5
13 3
3 10
5 12
12 17
12 10
8 6
5 17
12 25
4 16
2 3
12 11
4 11
3 5
13 23
13 5
3 8
11 20
9 19
11 6
13 4
13 17
10 21
2 12
2 5
13 12
12 13
13 25
4 13
2 2
10 22
7 23
13 2
5 2
2 10
13 6
9 16
7 5
4 25
13 19
11 7
11 17
2 11
10 20
2 25
11 25
7 8
9 12
