14 26
###################...####
#.....#...........#####..#
#.##.##.#.#.#.#.#........#
#.##.#............#.##...#
#.##.##.#.#.#.#.#......#.#
#.#...............###.##.#
#.##.#.....##.#....##.##.#
#.#...................##.#
#.#..#...#.##.#....##.##.#
#.....#..#.##.#.#.###.##.#
#.#.#...........#.###.##.#
#........#.#.............#
###...######....########.#
#######....######......###
8 14
13
7 14
8 13
9 14
11 11
4 16
8 9
12 18
8 18
7 10
3 16
11 25
5 2
8 15
6 4
3 2
2 6
11 4
5 16
13 25
13 4
12 11
2 2
3 16
11 25
5 2
8 4
