14 26
##########################
#........................#
#..##############........#
#..#............########.#
#..#...###.......#.....#.#
#..#...#.#####...#.....#.#
#..#...#.....##.##...###.#
#..#####.#####...##..#...#
#..#.........#...##.##.###
#..#...#.#.......#...#.###
#..#.....#.###.......#...#
#..#####.#.###...#######.#
#........####............#
##########..##############
10 23
28
11 11
6 6
11 2
7 16
6 7
9 15
10 7
13 16
9 17
7 10
6 22
11 18
4 10
9 20
3 19
2 24
6 5
7 9
5 3
3 22
9 2
9 9
11 3
9 23
5 14
10 14
11 15
11 6
6 9
7 7
5 19
11 23
6 2
7 16
10 3
3 3
11 5
7 6
11 18
8 15
4 10
13 2
9 20
5 11
3 23
7 5
12 11
8 17
11 7
12 15
13 14
7 13
9 9
3 18
10 14
2 25
