8 11
###########
#......####
#......####
#........##
#........##
##.#####.##
##........#
###########
3 6
4
6 3
5 7
5 5
5 3
2 7
3 2
2 3
2 2
