14 25
#########################
##...................####
#.#########.########.####
#.......#.#..#.#.#.#.####
#.......#.#............##
#..###..###............##
##........#....#######.##
##.............#.....#.##
##..#########..#.....#.##
##.............#..####..#
##....##########..#.....#
####..............#######
####..............#######
#########################
5 2
3
8 14
7 8
8 4
9 21
2 3
11 20
