8 10
##########
#........#
#........#
##.###.#.#
#......#.#
#......#.#
######...#
##########
6 2
6
6 4
6 7
3 3
6 6
3 8
3 5
6 4
5 4
5 5
6 6
5 6
6 5
