12 17
#################
########.......##
########.......##
########...###.##
########...#...##
########...#....#
#########.##....#
#.....#....#...##
#.....#....#...##
##.........#...##
##.............##
#################
11 3
15
3 15
10 3
10 11
11 4
5 11
10 10
3 10
9 3
11 9
3 11
8 10
8 9
9 6
9 5
6 15
3 15
8 14
9 13
8 13
9 14
9 15
4 15
10 13
10 15
10 14
11 14
2 15
11 15
8 15
11 13
