12 25
#########################
#.##...#.#......#.#.....#
#........#.#.####.....###
#........#...#....#.....#
#.##...#.#...#.##.#######
########.##.##.........##
########.##.##.#.......##
##....##.......##########
#...#....##.##....#....##
#......#.########......##
##....##.#........#....##
#########################
9 12
14
7 20
11 17
4 6
3 22
4 4
9 22
10 6
11 22
3 21
6 20
4 12
3 6
9 6
3 4
2 16
11 11
9 20
9 2
2 2
11 9
7 18
11 20
4 24
2 24
7 17
5 2
10 9
10 2
