8 13
#############
#....########
#.....#######
#...#...#####
##....#.....#
###.........#
####........#
#############
3 3
3
5 6
4 4
3 4
7 12
6 12
5 12
