7 10
##########
###......#
##.......#
##..###..#
#........#
#.....##.#
##########
6 9
6
5 9
4 8
4 4
3 6
3 4
5 8
2 7
2 6
2 9
2 8
2 5
2 4
