9 13
#############
##.........##
#...........#
#...........#
#...........#
#...........#
#...........#
##.........##
#############
8 7
13
4 10
5 9
4 9
3 3
5 5
4 5
7 6
4 4
3 11
7 7
8 5
8 9
7 8
4 10
4 9
5 11
4 5
5 6
7 9
4 4
7 5
8 8
8 7
8 6
5 8
5 3
