11 16
################
#...############
#........#######
#..###.#.......#
#..##..###.#####
#.##...###.#####
##.........#####
##.##.##########
##..#..........#
##.....#########
################
9 15
2
6 11
9 14
4 15
6 2
