14 26
##########################
#.....#..................#
#.....#......###.......#.#
#...#.......#..#.......#.#
#.#####...###..##.....##.#
###...###......#########.#
##########..#..........#.#
###########.#.#........#.#
###########...#........#.#
###############........#.#
###########...#.......#..#
###########...#.######...#
###########..............#
##########################
2 2
37
4 7
10 17
2 18
4 18
12 12
3 11
3 21
5 19
8 19
2 22
10 21
4 22
2 5
6 14
8 14
3 3
9 21
10 18
12 24
9 17
6 15
4 10
3 2
12 14
8 21
2 20
10 19
3 9
2 3
11 21
8 17
4 20
4 11
11 17
3 8
3 18
8 18
11 16
7 21
8 23
2 18
2 8
5 19
2 22
7 16
11 14
12 16
2 5
2 19
2 9
4 4
13 16
4 23
5 22
8 16
7 23
4 10
2 6
13 15
2 20
4 14
2 10
9 16
5 21
7 22
11 12
4 6
10 16
2 21
4 15
2 11
9 23
6 13
5 2
