8 9
#########
###..####
###.....#
#.......#
#.......#
###..####
###..####
#########
7 4
5
5 4
5 6
4 4
6 5
3 5
5 4
5 5
5 6
3 6
3 4
