11 14
####......####
#..########..#
#.....##.....#
#............#
###...##...###
#####.##.#####
###...##...###
###........###
##....##....##
##..######..##
#####....#####
9 5
8
4 10
5 10
5 5
4 5
8 10
4 12
4 3
8 5
4 7
4 6
4 8
5 6
8 8
3 6
7 10
8 7
