14 26
##########################
####.........#..#..#.....#
#..###.......#....#......#
#..#.#########.#.........#
#.#.........##...###.....#
#...#..#....##..#......###
#..###.....###....#.#.##.#
#..#..#.....##...........#
#.##..#.......#......##..#
####..#...........#......#
##..........##.#....###.##
###.#..#.##.##.#..#.##...#
#######.....##.#....#....#
##########################
13 25
9
6 9
10 17
3 23
11 9
9 9
2 23
4 23
4 25
4 24
3 24
3 25
3 23
2 23
4 23
4 25
2 25
4 24
2 24
