8 10
##########
##......##
###....###
#........#
#........#
###....###
##......##
##########
4 2
4
4 5
4 6
6 5
6 6
7 8
2 8
2 3
7 3
