8 8
########
#....###
#.##...#
#......#
##.##..#
#......#
#.....##
########
4 2
4
6 6
4 3
3 6
3 5
6 3
7 3
7 2
5 3
