13 11
###########
##..#######
#....#.##.#
#....#....#
##.###.#..#
##.#......#
##.###.#..#
##........#
##..##....#
#####..#..#
#####.....#
####...##.#
###########
7 10
8
5 9
6 9
4 9
11 9
9 9
8 9
10 9
7 9
4 5
3 10
10 6
12 10
12 5
3 7
6 5
3 5
