14 9
#########
####.####
##....###
##....###
##....###
##....#.#
##....#.#
##......#
#......##
#.....###
#.....###
##....###
##.##.###
#########
11 5
6
7 3
4 6
7 6
4 4
9 3
7 4
6 4
5 4
6 6
5 6
11 2
9 5
