7 9
#########
#.......#
#.......#
#..#....#
#.......#
#.......#
#########
6 2
6
5 4
4 5
5 6
4 3
3 4
6 5
6 4
4 6
6 6
2 8
4 2
2 4
