11 9
#########
###....##
###.....#
####.#..#
##......#
##..##..#
##......#
#...#..##
#.##..###
#....####
#########
5 6
7
6 4
8 6
5 5
4 8
5 7
7 5
3 7
8 3
5 5
3 8
3 6
2 4
5 8
5 3
