13 12
############
#####..#####
#####..#####
#####..#####
#####..#####
#..........#
#..........#
#####..#####
#####..#####
#####..#####
#####..#####
#####..#####
############
12 7
8
11 7
6 8
6 6
5 6
7 6
7 4
11 6
9 7
7 3
6 8
5 6
6 10
8 7
3 7
9 6
6 5
