9 11
###########
###....####
###....####
##.......##
##.......##
#.........#
#........##
#####.#####
###########
4 5
4
5 6
6 3
6 7
3 6
6 6
5 5
4 6
5 7
