8 15
####.....######
#..#....##..###
#..#....#....##
#..######....##
#......#......#
#....#.#..#.#.#
###......#....#
###############
5 6
6
6 4
5 4
3 3
5 11
4 13
6 12
4 10
6 12
6 3
4 12
4 2
5 3
