11 24
########################
#####................#.#
###.#.####...........#.#
##..###..#############.#
#....#...#.#.#.#.#.#...#
#......................#
#....#...#.#.#.#.#.#...#
##..###..#############.#
###.#.####...........#.#
#####................#.#
########################
5 4
3
6 19
5 9
7 9
3 23
6 23
9 23
