8 11
###########
#...#######
#...#######
#...#..####
#...####..#
#.........#
#..#......#
###########
7 2
6
6 9
6 8
4 4
6 3
4 3
5 3
5 9
6 9
5 10
6 10
7 10
7 9
