13 14
##############
#....#.....###
###..#.#.#.###
###..#.....###
###..#.###.###
###..#.......#
###..#######.#
####.........#
#########.####
###........###
###........###
###........###
##############
6 4
8
5 4
11 10
2 9
11 5
11 8
3 9
11 6
3 5
11 10
5 11
11 8
2 11
9 10
2 2
2 5
11 6
