9 9
#########
##.....##
#......##
#..##...#
##......#
#..#.#..#
#.......#
###....##
#########
4 8
8
5 4
4 7
3 3
5 6
7 7
8 5
3 6
3 4
4 7
2 6
6 7
4 6
2 3
4 3
8 7
6 5
