14 17
#################
##########.#....#
#########..#....#
######..........#
######.###.##...#
######.###.#..###
#...##...#.....##
#.#.####...#...##
#...######.######
#.#.#...##.######
#.......##..#####
#####...........#
##########..#####
#################
2 16
5
11 7
8 11
9 3
4 13
5 14
3 15
3 16
11 7
12 16
2 15
