8 6
######
##...#
##...#
#...##
#...##
#..###
#..###
######
5 4
2
4 4
4 3
5 2
5 3
