7 7
#######
###...#
#.....#
#.....#
##..###
##..###
#######
3 5
2
4 4
4 3
3 4
5 3
