7 7
#######
###..##
#....##
#....##
###...#
###...#
#######
3 5
2
4 4
3 4
6 5
6 6
