6 8
########
##.....#
#......#
#....###
#....###
########
4 5
3
3 4
3 3
3 5
4 4
3 4
2 4
