6 8
########
#......#
#......#
###..###
###..###
########
2 5
2
3 4
2 4
2 3
3 6
