8 7
#######
##..###
##....#
##....#
#...###
#...###
#...###
#######
7 4
3
6 3
4 3
5 3
3 4
3 6
3 5
