8 8
########
##..####
##..####
##..####
###....#
#......#
#....###
########
6 7
3
5 4
5 5
6 6
7 5
6 5
6 6
