14 14
##############
####...#######
#.........####
#..#...#######
#..#......####
#..#...#######
#..#......####
#..#...#######
#..#......####
#.........####
#..####...####
#............#
#............#
##############
7 10
11
4 7
6 7
10 4
11 8
12 12
9 9
12 6
12 4
8 7
12 10
3 4
5 9
5 10
4 6
6 6
4 5
3 10
5 7
3 9
8 6
8 5
6 5
