10 11
###########
#.........#
#.#.#.#.#.#
#...#.#...#
#.#.#.#.#.#
#.........#
#.#######.#
#.#.....#.#
#.#.....#.#
###.....###
4 6
8
4 10
6 9
4 9
4 8
4 4
6 3
4 3
4 2
8 2
9 2
6 10
8 10
9 10
6 2
7 10
7 2
