10 11
###########
#.........#
#.#.#.#.#.#
#.#.#.#.#.#
#.#.#.#.#.#
#.........#
#.#######.#
#.#.....#.#
#.#.....#.#
###.....###
4 6
6
4 10
6 9
4 8
4 4
6 3
4 2
8 2
9 2
8 10
9 10
7 10
7 2
