11 9
#########
#...#####
#...#####
#...#..##
###.....#
###.....#
##......#
#.......#
#.......#
##.....##
#########
3 4
10
8 3
6 7
5 6
7 6
7 4
8 7
9 4
9 6
8 5
6 5
6 4
9 7
6 6
5 7
9 3
7 7
9 5
7 5
8 6
8 4
