13 17
#################
#...#...#...#...#
#.#.#...#.#.#...#
#.......#.......#
###.#.#####.#.###
#...............#
#...#.#.#...#.#.#
#...#...#...#...#
#####.#####.#####
#####...#...#####
#######.#.#######
#######...#######
#################
6 9
14
3 15
4 7
7 3
6 7
6 11
7 12
4 15
7 6
6 3
4 3
7 11
3 7
6 15
4 11
5 4
6 9
6 6
4 5
5 6
5 12
4 4
4 14
4 13
5 14
6 13
6 12
9 6
6 5
