12 12
############
##..########
##......####
#...#....###
#...##....##
###.#...#.##
##......#.##
##..#.###.##
##.....##..#
####.......#
#####...#..#
############
9 5
9
3 3
6 8
4 8
10 7
5 7
4 3
9 6
10 9
3 5
5 10
3 3
6 8
4 8
10 7
5 7
9 6
10 9
3 5
