11 11
###########
#.........#
#.#####...#
#.....#...#
##.....##.#
#.......#.#
#.......#.#
#.......#.#
##......#.#
###...#...#
###########
4 9
12
5 4
8 3
6 7
5 6
7 6
6 3
7 4
8 7
9 4
9 6
8 5
6 5
6 4
7 3
9 7
5 5
6 6
5 7
9 3
7 7
9 5
8 4
8 6
5 3
