9 11
###########
#......####
##.....####
#.......#.#
#.........#
###..#..#.#
###.#####.#
###.......#
###########
2 2
8
3 3
4 6
5 5
4 4
5 7
5 3
3 7
3 5
5 4
4 6
5 5
4 5
4 3
3 6
3 7
3 4
