11 9
#########
#...#####
#.#.#####
#...#..##
#......##
#.#.....#
##......#
#.......#
#.......#
##.....##
#########
3 4
11
8 3
6 7
5 6
7 6
7 4
8 7
9 4
9 6
8 5
6 5
5 3
6 4
9 7
6 6
5 7
9 3
7 7
9 5
7 5
8 4
8 6
5 3
