8 11
###########
##.......##
##.......##
##.......##
#.........#
#.........#
##...#...##
###########
5 6
6
6 4
6 9
6 8
4 6
6 3
3 6
5 4
4 7
6 7
5 8
4 5
6 5
