10 17
#################
#####.......#####
#####.......#####
#####.......#####
#######...#######
##...#.....#...##
#...............#
#......###......#
##.....###.....##
########.########
3 9
16
4 10
7 14
8 14
5 10
8 13
4 8
7 12
3 10
7 6
8 5
3 8
7 4
7 10
7 8
5 8
8 4
4 10
7 14
8 14
8 13
4 8
7 12
8 12
3 10
7 6
7 13
3 8
7 4
7 5
8 6
8 5
8 4
