10 14
##############
#######..#####
#######......#
##....#.###..#
#.....#.###.##
##..........##
#######.##..##
#######.######
#######.######
##############
5 2
3
5 6
5 4
5 5
9 8
8 8
7 8
