7 8
########
##....##
##.##..#
#......#
#..#...#
#....###
########
6 4
3
4 5
5 5
3 6
4 4
3 3
4 3
