14 15
######....#####
###..######...#
###...........#
###...######.##
####..#....#.##
####.##....#.##
####.#..####.##
####.####.....#
#.............#
#.#...#########
#.#...#########
#.##.##########
#....##########
###############
7 5
7
3 12
10 4
8 11
7 13
10 6
12 5
8 5
4 5
4 4
3 6
2 5
3 4
2 4
3 5
