11 16
################
#..............#
#..............#
###.###........#
#............###
#............###
#............###
#.....####...###
###...#..#...###
#######..#...###
################
4 15
19
4 8
7 12
4 12
3 7
3 14
4 9
3 3
5 12
4 13
4 10
4 14
6 12
4 11
5 3
3 5
3 12
8 12
5 7
9 12
7 3
6 6
6 2
9 4
8 5
7 2
7 6
6 3
8 6
6 4
8 2
7 5
9 6
6 5
8 3
7 4
9 5
5 2
8 4
