11 16
################
#..............#
#..............#
###.###........#
#............###
#............###
#............###
#.....####...###
###...#..#...###
#######..#...###
################
4 15
12
4 10
3 3
4 8
7 12
5 12
5 7
6 12
4 14
4 12
5 3
3 7
3 5
6 4
7 3
8 3
8 2
6 3
7 4
6 2
9 4
9 5
9 6
7 2
8 4
