10 14
##############
#######.....##
######.......#
#####...#.#..#
#............#
#.......#.#..#
#####........#
######.......#
#######.....##
##############
4 12
14
4 7
3 12
5 5
6 7
5 12
5 7
7 9
3 11
8 10
3 9
8 8
7 11
6 12
5 3
4 10
5 9
5 10
8 13
3 13
5 11
2 8
6 10
5 13
2 10
9 10
6 2
2 12
6 5
