8 9
#########
#...#...#
#..#.#..#
#.......#
#..#.#..#
#.......#
#.......#
#########
5 5
5
6 4
6 7
3 3
4 4
3 7
2 7
2 6
2 8
7 2
3 5
