9 13
#############
#.....#.....#
#....#.#....#
#...#...#...#
#..#.....#..#
#.#.......#.#
#...........#
#...........#
#############
3 11
5
3 10
2 11
7 10
6 12
4 11
4 10
8 12
2 8
3 9
3 7
