9 13
#############
#.....#.....#
#....#.#....#
#...#...#...#
#..#.....#..#
#.#.......#.#
#...........#
#...........#
#############
3 11
8
7 3
3 10
2 11
7 10
6 12
5 2
2 4
4 11
4 10
2 6
8 2
8 12
2 8
6 10
3 9
3 7
