6 6
######
#....#
#....#
#.#..#
#....#
######
3 4
2
4 4
3 3
4 5
2 3
