6 8
########
#......#
#...#..#
#.#....#
#......#
########
5 5
5
4 6
3 3
4 5
4 4
5 3
2 6
4 2
2 5
5 2
2 4
