9 10
##########
####...###
#.......##
#....#...#
#........#
#........#
####...###
####...###
##########
5 7
7
4 7
3 3
6 8
5 6
6 3
7 5
5 3
2 7
3 2
4 9
3 8
8 7
2 5
5 2
