11 13
#####...#####
#...#####..##
#.#.#......##
#.......#...#
###.#.###.#.#
##..#.....#.#
#.......#.#.#
#..####.....#
#...##....###
###....######
#############
10 5
10
4 7
6 9
6 7
8 3
4 5
8 11
9 8
8 9
8 8
3 7
6 9
6 8
4 5
5 6
8 11
8 10
9 10
3 6
7 10
7 8
