9 11
####...####
#..#####..#
#.........#
#....#....#
##...#...##
##...#...##
###..#..###
###..#..###
###########
8 8
8
5 9
4 5
5 7
7 7
3 9
3 6
7 8
6 5
6 4
5 4
4 9
6 8
4 8
4 4
4 3
5 8
