13 18
##################
#...##############
#.#.........######
#.#...###....#####
#....##.##....####
#.#.##...##....###
#...#.....##....##
#.#.###....##....#
#.#...##....##..##
#......##.#..##..#
####......##..####
########.........#
##################
10 17
9
6 4
7 14
8 15
11 8
5 12
6 13
9 5
4 11
8 4
12 15
6 7
6 8
7 6
7 7
12 17
12 16
7 8
5 8
