8 11
###########
#..#......#
#..#.....##
#.......###
#..#...####
#..#..#####
#....######
###########
2 10
4
3 8
4 7
5 6
3 6
3 2
2 3
3 3
2 2
