11 25
#########################
#####.......#####..######
#...#########...#.....###
#.#.#.........#.#.###.###
#.......#.......#...#.###
#####...###.###....##.###
######..#.#.........#.#.#
######.##.######.####...#
#########......#.#...#.##
################...#...##
#########################
8 7
3
5 7
6 8
7 7
6 19
5 20
7 20
