10 15
###############
##..###########
#.............#
#..#.#....##..#
#.......#..#..#
#..#..###.....#
#.............#
####.#.....####
####.......####
###############
5 3
5
8 11
8 9
8 7
7 10
7 8
5 4
5 13
6 3
4 3
5 2
