12 9
#########
###..####
#......##
#....#..#
#..#....#
#.##.#..#
#.#.....#
#...##.##
#####...#
#####...#
#####...#
#########
7 8
4
5 6
6 5
4 4
3 6
10 7
9 8
9 6
11 6
