20 23
#######################
#..####################
#....#................#
#.#..#........#.#.#...#
###.##..##.#........#.#
#.#.##..#..#.#...#....#
#...##..##.#...#...#..#
#....#.....#..........#
##.#.#..##.#.##########
##.#.##..#.###......###
##.#.....#..........###
##.#.#.#.#....##...####
##.#.#.#.#....#..#..###
##.....###..#.#..##.###
##.###.#........##..###
##..#..#..#..#......###
##.##..#............###
##.....################
##..###################
#######################
11 20
18
11 16
7 14
7 21
17 6
16 10
5 16
4 18
5 18
4 14
7 18
4 16
5 14
6 20
12 18
4 21
9 5
4 20
6 16
15 12
14 14
13 12
15 13
13 13
15 19
16 10
13 14
15 20
17 9
17 11
14 12
15 14
13 19
4 2
13 20
12 9
14 20
