17 30
######...............#########
###..######..........#..######
###.......############.......#
###..##.#...............#.##.#
###...#.......######....#.##.#
####..#..######....#..#.#.##.#
###..##..##...#....##...#.##.#
###.....##....###..#....#.##.#
###.#..##....###..##..#.#.##.#
###.####....###....#....#....#
###.#......###....##.#..######
##..##.....##....##.........##
#....####.##....##....#.....##
#.........#....##...#....#..##
##.#####......##..#....#....##
####...####..##.............##
##############################
7 16
20
13 22
6 9
15 20
13 26
5 13
6 24
5 23
15 26
9 21
14 27
6 22
10 22
14 23
7 23
13 24
5 11
14 19
14 25
12 23
7 8
8 13
7 12
7 16
6 17
8 14
10 12
9 12
12 3
7 14
13 2
15 3
12 7
14 2
9 13
11 7
8 12
7 13
7 17
6 16
11 6
