14 19
###################
####.....##..#..###
###.....##......###
##.....##....##.###
#.....##....##..#.#
#....##....##.....#
#...##....##..#.#.#
#..##....##..##.#.#
#.......##..###.#.#
####...##...###.#.#
####..##..........#
##########....#####
###########...#####
###################
2 9
10
6 4
7 3
10 5
5 5
4 6
11 5
12 13
3 7
6 17
11 6
10 5
13 12
12 14
13 13
11 5
12 13
13 14
12 12
12 11
11 6
