20 20
####################
########...#########
########...#########
########.........###
########.........###
###...##...........#
##.....#...#####...#
##.###....##...#.#.#
##.##....##....#...#
##.#....##....##.#.#
##.#...##....##....#
##....##....##.....#
##...##....##..#.###
##..##....##.....###
#..##....##...#..###
#.......##.......###
##.....##....#.#.###
##....##...#.....###
#######..........###
####################
19 8
23
16 16
5 13
4 12
12 16
9 18
17 15
6 14
6 10
18 16
17 17
11 18
4 10
5 11
4 14
7 18
4 16
14 15
6 12
15 14
18 10
18 14
17 12
6 16
8 13
7 7
18 4
17 3
13 8
14 9
12 9
8 14
11 10
9 15
16 3
18 5
8 15
11 13
17 5
16 4
10 13
12 11
13 10
9 13
16 5
18 3
10 14
