10 14
##############
#######....###
##...........#
#..##....#...#
##.....#...#.#
#..#.#...#...#
#....#.....###
#...##########
##...#########
##############
9 5
7
6 9
5 10
6 8
5 11
4 8
5 7
4 12
5 4
3 5
7 4
7 5
9 4
9 5
8 4
