14 18
##################
###############..#
##############...#
#................#
#..#........###..#
#....#####..#.#.##
#.#..#...#.##.#..#
#....#........#..#
#..#.#......#.#..#
#....########.####
#.#...........####
#....####...######
###..#..##########
##################
12 11
19
4 7
8 13
11 11
5 6
8 9
7 11
10 3
5 8
5 12
6 3
9 11
5 17
9 3
7 5
5 3
5 10
6 16
11 6
8 4
9 8
13 4
7 7
12 5
7 16
3 17
8 14
8 16
9 7
5 17
9 16
8 7
2 17
4 17
13 5
8 8
12 4
7 8
6 16
