8 9
#########
#..#...##
#.......#
#..#....#
#..#....#
#.......#
#..#...##
#########
7 2
6
4 7
6 7
4 5
5 6
3 6
6 5
7 3
3 3
6 2
2 3
2 2
7 2
