15 19
###################
###########.....#.#
##########........#
#########....##...#
########....##..#.#
#######....##.....#
######....##....#.#
#####....##...#...#
####....##..#.....#
###....##.......#.#
#.....##.....#....#
##...##....#...#..#
###.##..#..#.#....#
#####.............#
###################
11 2
10
8 13
7 15
12 14
9 15
10 13
12 9
11 15
6 17
11 12
13 10
6 9
10 5
5 10
3 12
11 4
12 3
8 7
9 6
7 8
4 11
