11 12
############
##..########
#.....#....#
#..........#
#...####...#
##..#..#.#.#
#####....#.#
####...#...#
####.......#
########...#
############
5 2
4
8 9
9 8
7 8
8 7
5 4
4 4
3 3
4 3
