10 18
##################
#....#############
#....#.###########
#...####..########
#......#.....#####
#.............####
#....#.....#...###
#...######......##
#####....###.....#
##################
3 5
10
5 9
6 4
7 3
3 3
5 5
6 6
7 9
4 4
6 10
5 3
8 14
9 13
9 14
7 13
9 16
9 17
6 13
8 16
8 15
6 14
