10 12
############
##......####
#..#..#....#
#.###......#
#..#...#...#
#.....###..#
##..#..#...#
###........#
######...###
############
9 9
4
7 4
7 6
6 5
4 8
5 9
5 7
7 7
7 9
