11 15
###############
###......######
###......######
###...#.....###
##....#......##
##.#.##......##
##....#..#...##
#.....#.###..##
#....##..#....#
######........#
###############
9 2
7
6 9
5 10
8 13
6 11
7 12
5 12
9 12
5 4
8 3
6 3
7 4
9 4
8 5
6 5
