8 8
########
#....###
#..#.###
#..#..##
#......#
#..#...#
####...#
########
2 4
3
5 4
5 5
5 6
4 3
5 3
6 3
